20
  ******************
* *  * *   *       *
* ** * * ****   *  *
*        ****  * * * 
******           * *
*   * **           *
*   *  *  ******** *
*** *  *   *     * *
*   *      *  ** * *
*    ***   *  ** * *
*  *   *   ** ** * *
*  *   * ****  * * *
*  *  *  *     * * *
*  * *  * ***  * * *
*  *** * *     * * *
*  *   * *     * * *
*  *   * *   *** * *
*      ***    *   **
*             * *  *  
****************** X